##########################################
# Syntax Coloring Map For KLineKWP1281Lib
##########################################

##########################################
# Datatypes (KEYWORD1)
##########################################

KLineKWP1281Lib	KEYWORD1
executionStatus	KEYWORD1
measurementType	KEYWORD1

##########################################
# Functions (KEYWORD2)
##########################################

KWP1281debugFunction	KEYWORD2

custom5baudWaitFunction	KEYWORD2
customErrorFunction	KEYWORD2

attemptConnect	KEYWORD2
connect	KEYWORD2
update	KEYWORD2
disconnect	KEYWORD2

getPartNumber	KEYWORD2
getIdentification	KEYWORD2
getExtraIdentification	KEYWORD2
getCoding	KEYWORD2
getWorkshopCode	KEYWORD2

login	KEYWORD2

recode	KEYWORD2

readFaults	KEYWORD2
getFaultCode	KEYWORD2
isOBDFaultCode	KEYWORD2
getOBDFaultCode	KEYWORD2
getFaultDescription	KEYWORD2
getFaultDescriptionLength	KEYWORD2
getFaultElaborationCode	KEYWORD2
getFaultElaboration	KEYWORD2
getFaultElaborationLength	KEYWORD2
clearFaults	KEYWORD2

readAdaptation	KEYWORD2
testAdaptation	KEYWORD2
adapt	KEYWORD2

basicSetting	KEYWORD2
getBasicSettingValue	KEYWORD2

readGroup	KEYWORD2
getFormula	KEYWORD2
getNWb	KEYWORD2
getMWb	KEYWORD2
getMeasurementData	KEYWORD2
getMeasurementDataLength	KEYWORD2

getMeasurementType	KEYWORD2
getMeasurementValue	KEYWORD2
getMeasurementUnits	KEYWORD2
getMeasurementText	KEYWORD2
getMeasurementTextLength	KEYWORD2
getMeasurementDecimals	KEYWORD2

getFormulaFromHeader	KEYWORD2
getNWbFromHeader	KEYWORD2
getMWbFromBody	KEYWORD2
getDataTableFromHeader	KEYWORD2
getDataTableLengthFromHeader	KEYWORD2

getMeasurementTypeFromHeader	KEYWORD2
getMeasurementValueFromHeaderBody	KEYWORD2
getMeasurementUnitsFromHeaderBody	KEYWORD2
getMeasurementTextFromHeaderBody	KEYWORD2
getMeasurementTextLengthFromHeaderBody	KEYWORD2
getMeasurementDecimalsFromHeader	KEYWORD2

readROM	KEYWORD2

outputTests	KEYWORD2
getOutputTestDescription	KEYWORD2
getOutputTestDescriptionLength	KEYWORD2

##########################################
# Constants/variables (LITERAL1)
##########################################

FAIL	LITERAL1
SUCCESS	LITERAL1
ERROR	LITERAL1
GROUP_BASIC_SETTINGS	LITERAL1
GROUP_HEADER	LITERAL1
GROUP_BODY	LITERAL1

UNKNOWN	LITERAL1
VALUE	LITERAL1
TEXT	LITERAL1

initComplementDelay	LITERAL1
complementDelay	LITERAL1
byteDelay	LITERAL1
blockDelay	LITERAL1

initResponseTimeout	LITERAL1
complementResponseTimeout	LITERAL1
echoTimeout	LITERAL1
responseTimeout	LITERAL1
byteTimeout	LITERAL1
